Seo Moon Tak - 형 (兄)
Dovlvl, BünyTune - WALKIE TALKIE
ASH ISLAND - A Chance Encounter
Dk Soul - 너라는 햇살
Pateko, SHIRT, MINAMI - teachmehowtoloveyou (feat. MINAMI of RESCENE)
Juwon - puzzle
Yumewanaii, XiiiDolor - WE GO
Gabby Onme - YOUR RHYTHM
Yeoeun - The days filled with you
Zivenew - Snowrise
Taeheon - Resolution
kyurin - enticing
Taru - coward
GoodGood - Gravity
Justb - GOING SOUTH (prod. O kwon & heyzuko!)
ATEEZ - From (2018)
WOODZ - Falling (Feat. Young K (DAY6))
Park Ju Won, Danny Koo - Danza del Este (feat. Danny Koo)
Park Ju Won, You Chaehoon - My Confession (feat. You Chaehoon)
Switcbak - Changes
Song Minhye - mars
MangoPhalt - We'll Get Back Together (inst.)
MuzGrain - Becoming the Sea
MuzGrain - Unfolding, Blooming
EachOne - Back Seat (feat. Soy_on)
EachOne - Puzzle (feat. Soopia)
EachOne - WooNaNaNa (feat. Rico, YOUS)
MOON haewon - The November Song
Choi Yu Ree - Between Earth and Sky
Miso - Spotlight
Jung Jae Wook - So I will… (Instrumental)
JinSoul - Ring of Chaos
SURL - Please Stay
OXN - SWIRKY
Naked Tapes - Girls
Ju Seong - Midnight in summer
SeoEun, Krid - LUM (feat. KRID)
D.ark, TRADE L - 1010(天天)
D.ark - G
DKB - Irony